----------------------------
-------------..-------------
-------------..-------------
-------------..-------------
-------------..-------------
-------------..-------------
-------*..... J.....*-------
------------.--.------------
--------.....  .....--------
------------.--.------------
---------.... f....---------
------------.--.------------
----------...  ...----------
------------.--.------------
-----------*.  .*-----------
------------.--.------------
------------.  .------------
------------.--.------------
------------r-- ------------
------------IPCB------------
----------------------------
