----------------------------------------------------------------------------------------------------------------------------------
--------------------........*...........----------....*.....    J     ....*.....---------------.......*.......--------------------
----------------------------.-------------------------.--------- ---------.---------------------------.---------------------------
----------------------------                                     f                                     ---------------------------
-----------------------------------------------------------------r----------------------------------------------------------------
----------------------------------------------------------------IPCB--------------------------------------------------------------
----------------------------------------------------------------------------------------------------------------------------------